************************
************************
************************
***_***_**__***_**_*****
****_*_**_**_**_**_*****
*****_***_**_**_**_*****
*****_***_**_**_**_*****
*****_****__****__******
************************
*_******__****___**___**
*_*****_**_**_******_***
*_*****_**_***__****_***
*_*****_**_*****_***_***
*____***__***___****_***
************************
************************
************************
************************
************************
************************