*******************H****
*****S******************
************************
**_________*******S*****
************************
***************______***
************************
*___********************
***M********************
**M*********************
*M****************__****
************************
************************
****s*******************
************************
_________***____________
************************
************************
________________________
************************