************************
************************
*****H*******_________**
*_________**S***********
************************
************************
************************
*_________***_________**
************************
******S*****************
*************_________**
*_________**************
************************
********M****_________**
*_________**************
************************
***S********************
************************
________________________
************************