************************
******M*****************
***************____*****
**___*******S***********
************************
***************_********
************************
***_________************
************************
**M****************__***
*___********************
************************
************************
****___***********S*****
************************
************************
***M********************
***********H************
________________________
************************