************************
__*********************_
************************
M*_________******_S*****
************************
***************______***
***********S************
______******************
****************______**
**S*******H*************
************************
*****_______************
************************
M***_______*________****
__********************__
************************
***S********************
***********M************
________________________
************************